{
  "starting_positions": [[0, 0], [1, 0], [2, 0], [3, 0]],
  "size": [12, 10],
  "finish_positions": [[3, 4]],
  "ground_map": [
    [1, 1, 1, 1, 1, 0, 1, 1, 1, 1],
    [1, 1, 1, 1, 1, 0, 1, 1, 1, 1],
    [1, 1, 1, 1, 1, 0, 1, 1, 1, 1],
    [1, 1, 1, 1, 1, 0, 1, 1, 1, 1],
    [1, 1, 1, 0, 1, 1, 1, 0, 1, 1],
    [1, 1, 1, 0, 1, 1, 1, 0, 1, 1],
    [1, 1, 1, 1, 1, 0, 1, 1, 1, 1],
    [1, 1, 1, 1, 1, 0, 1, 0, 1, 0],
    [1, 1, 1, 1, 1, 0, 1, 0, 1, 1],
    [1, 1, 1, 1, 1, 0, 1, 0, 1, 1],
    [1, 1, 1, 1, 1, 0, 1, 0, 1, 1],
    [1, 1, 1, 1, 1, 0, 0, 0, 1, 1]
  ],
  "obstacles_map": [
    [0, 0, 0, 0, 0, 0, 0, 0, 0, 0],
    [0, 0, 0, 0, 0, 0, 0, 0, 0, 0],
    [0, 3, 0, 0, 0, 0, 0, 0, 0, 0],
    [0, 0, 0, 0, 0, 0, 0, 0, 0, 0],
    [0, 0, 0, 0, 3, 1, 3, 0, 0, 0],
    [0, 0, 0, 0, 3, 1, 3, 0, 0, 0],
    [0, 0, 0, 0, 0, 0, 0, 0, 0, 0],
    [0, 0, 0, 0, 0, 0, 0, 0, 2, 0],
    [0, 0, 0, 0, 0, 0, 0, 0, 0, 0],
    [0, 0, 0, 0, 0, 0, 0, 0, 0, 0],
    [0, 0, 0, 0, 0, 0, 0, 0, 0, 0],
    [0, 0, 0, 0, 0, 0, 0, 0, 0, 0]
  ],
  "fishes_map": [
    [0, 0, 0, 0, 0, 0, 0, 0, 0, 0],
    [0, 0, 0, 0, 0, 0, 0, 0, 0, 0],
    [0, 0, 0, 0, 0, 0, 0, 0, 0, 0],
    [0, 0, 0, 0, 0, 0, 0, 0, 0, 0],
    [0, 0, 0, 0, 0, 0, 0, 0, 0, 0],
    [0, 0, 0, 0, 0, 0, 0, 0, 0, 0],
    [0, 0, 0, 0, 0, 0, 0, 0, 0, 0],
    [0, 0, 0, 0, 0, 0, 0, 0, 0, 0],
    [0, 0, 0, 0, 0, 0, 0, 0, 0, 0],
    [0, 0, 0, 0, 0, 0, 0, 0, 0, 0],
    [0, 0, 0, 0, 0, 0, 0, 0, 0, 0],
    [0, 0, 0, 0, 0, 0, 0, 0, 0, 1]
  ],
  "bonuses_map": [
    [0, 0, 0, 0, 1, 0, 0, 0, 102, 0],
    [0, 0, 0, 101, 0, 0, 0, 0, 0, 0],
    [0, 0, 0, 0, 0, 0, 0, 0, 0, 0],
    [0, 0, 0, 0, 0, 0, 0, 0, 0, 0],
    [0, 0, 100, 0, 0, 0, 0, 0, 0, 0],
    [0, 0, 100, 0, 0, 0, 0, 0, 0, 0],
    [0, 0, 0, 0, 0, 0, 0, 0, 0, 2],
    [0, 0, 0, 0, 0, 0, 0, 0, 0, 0],
    [0, 0, 0, 0, 0, 0, 0, 0, 0, 0],
    [0, 0, 0, 0, 0, 0, 0, 0, 0, 0],
    [0, 0, 0, 0, 0, 0, 0, 0, 0, 0],
    [102, 0, 0, 0, 1, 0, 0, 0, 0, 0]
  ],
  "starting_random_bonuses": 4
}