{
  "starting_positions": [[1, 1], [1, 10], [1, 4], [1, 7]],
  "size": [14, 12],
  "finish_positions": [[7, 0], [7, 11]],
  "map_name": "Rocky Swamps 14x12",
  "image_name": "rm.png",
  "ground_map": [
    [0, 0, 1, 1, 1, 0, 1, 1, 0, 0, 0, 0, 1, 1],
    [1, 1, 1, 1, 1, 1, 1, 0, 0, 0, 1, 0, 1, 1],
    [1, 0, 0, 1, 1, 0, 1, 1, 1, 1, 1, 1, 1, 1],
    [1, 0, 0, 1, 1, 0, 1, 1, 1, 0, 0, 1, 0, 1],
    [1, 1, 0, 1, 1, 0, 1, 0, 1, 1, 1, 1, 1, 1],
    [1, 1, 1, 1, 1, 1, 1, 0, 1, 1, 0, 1, 0, 0],
    [1, 1, 1, 1, 1, 1, 1, 0, 1, 1, 0, 1, 0, 0],
    [1, 1, 0, 1, 1, 0, 1, 0, 1, 1, 1, 1, 1, 1],
    [1, 0, 0, 1, 1, 0, 1, 1, 1, 0, 0, 1, 0, 1],
    [1, 0, 0, 1, 1, 0, 1, 1, 1, 1, 1, 1, 1, 1],
    [1, 1, 1, 1, 1, 1, 1, 0, 0, 0, 1, 0, 1, 1],
    [0, 0, 1, 1, 1, 0, 1, 1, 0, 0, 0, 0, 1, 1]

  ],
  "obstacles_map": [
    [0, 0, 0, 0, 0, 0, 0, 0, 0, 0, 0, 0, 0, 0],
    [0, 0, 0, 0, 0, 1, 0, 0, 0, 0, 0, 0, 0, 0],
    [0, 0, 0, 0, 0, 0, 0, 3, 3, 0, 0, 0, 0, 0],
    [0, 0, 0, 0, 0, 0, 0, 3, 3, 0, 0, 0, 0, 2],
    [0, 0, 0, 0, 3, 0, 0, 0, 0, 0, 0, 0, 2, 0],
    [0, 0, 0, 0, 3, 1, 0, 0, 0, 0, 0, 0, 0, 0],
    [0, 0, 0, 0, 3, 1, 0, 0, 0, 0, 0, 0, 0, 0],
    [0, 0, 0, 0, 3, 0, 0, 0, 0, 0, 0, 0, 2, 0],
    [0, 0, 0, 0, 0, 0, 0, 3, 3, 0, 0, 0, 0, 2],
    [0, 0, 0, 0, 0, 0, 0, 3, 3, 0, 0, 0, 0, 0],
    [0, 0, 0, 0, 0, 1, 0, 0, 0, 0, 0, 0, 0, 0],
    [0, 0, 0, 0, 0, 0, 0, 0, 0, 0, 0, 0, 0, 0]
  ],
  "fishes_map": [
    [0, 0, 0, 0, 0, 0, 0, 0, 0, 0, 0, 0, 0, 0],
    [0, 0, 0, 0, 0, 0, 0, 0, 0, 0, 0, 0, 0, 0],
    [0, 0, 0, 0, 0, 0, 0, 0, 0, 0, 0, 0, 0, 0],
    [0, 0, 0, 0, 0, 0, 0, 0, 0, 0, 0, 0, 0, 0],
    [0, 0, 0, 0, 0, 0, 0, 0, 0, 0, 0, 0, 0, 1],
    [0, 0, 0, 0, 0, 0, 0, 0, 0, 0, 0, 0, 0, 0],
    [0, 0, 0, 0, 0, 0, 0, 0, 0, 0, 0, 0, 0, 0],
    [0, 0, 0, 0, 0, 0, 0, 0, 0, 0, 0, 0, 0, 1],
    [0, 0, 0, 0, 0, 0, 0, 0, 0, 0, 0, 0, 0, 0],
    [0, 0, 0, 0, 0, 0, 0, 0, 0, 0, 0, 0, 0, 0],
    [0, 0, 0, 0, 0, 0, 0, 0, 0, 0, 0, 0, 0, 0],
    [0, 0, 0, 0, 0, 0, 0, 0, 0, 0, 0, 0, 0, 0]
  ],
  "bonuses_map": [
    [0, 0, 0, 0, 0, 0, 0, 0, 0, 0, 0, 0, 2, 0],
    [1, 0, 0, 0, 0, 0, 0, 0, 0, 0, 2, 0, 0, 0],
    [0, 0, 0, 0, 0, 0, 0, 0, 0, 0, 0, 0, 0, 0],
    [0, 0, 0, 0, 0, 0, 0, 0, 0, 0, 0, 0, 0, 0],
    [1, 0, 0, 0, 0, 0, 0, 0, 0, 0, 0, 0, 0, 0],
    [0, 0, 0, 0, 0, 0, 0, 0, 0, 0, 0, 0, 0, 0],
    [0, 0, 0, 0, 0, 0, 0, 0, 0, 0, 0, 0, 0, 0],
    [1, 0, 0, 0, 0, 0, 0, 0, 0, 0, 0, 0, 0, 0],
    [0, 0, 0, 0, 0, 0, 0, 0, 0, 0, 0, 0, 0, 0],
    [0, 0, 0, 0, 0, 0, 0, 0, 0, 0, 0, 0, 0, 0],
    [1, 0, 0, 0, 0, 0, 0, 0, 0, 0, 2, 0, 0, 0],
    [0, 0, 0, 0, 0, 0, 0, 0, 0, 0, 0, 0, 2, 0]
  ],
  "starting_random_bonuses": 16,
  "bonus_spawn_delay": 3,
  "bonus_spawn_amount": 7
}